###############
#             #
#             #
#             #
#             #
#    @**      #
#     .#      #
#             #
#             #
#             #
#             #
#   $         #
#             #
#             #
###############
