               
    #######    
 # # #.#   #   
  #  # # ##$#  
 #.       #  # 
  #     #    # 
 #   ##.##  $# 
 #    #.#    # 
 #           # 
 #   @     $ # 
 ##$#     #### 
  #   $####    
  # . #        
   ####        
               
